NO ./sprites/graystone.xpm
SO ./sprites/colorstone.xpm
WE ./sprites/graybrick.xpm
EA ./sprites/redbrick.xpm

F 255,255,255
C 0,0,0

111
1011
11N1
1111
