NO ./sprites/eagle.xpm
SO ./sprites/eagle.xpm
WE ./sprites/eagle.xpm
EA ./sprites/eagle.xpm

F 220,100,0
C 0,0,255

		1111111111111111111111111
		1000000111111111111111111
		10110001
		1001000111111111111111111
111111111011000001110000000000001
100000000011000001110111111111111
11110111111111011100000010001
111101111111110111010100100011
11000000110101011100000010001
10000000000000001100000010001
1000N000000000001101010010001
1100000111010101111101111000111
11110111 1110101 101111010001
11111111 1111111 111111111111
