NO ./sprites/eagle.xpm
SO ./sprites/eagle.xpm
WE ./sprites/eagle.xpm
EA ./sprites/eagle.xpm

F 220,100,0
C 0,0,255

111
1011
11N1
1111
