		   		SO     ./sprites/char_down1.xpm		 
 EA 	./sprites/colorstone.xpm		
F 	0,100,0	

NO  	./sprites/redbrick.xpm   
  	 	 	 	 WE 						 ./sprites/purplestone.xpm
C	0,0,255    

111111111111111111111111
100000000000000000000001
100000000000000000000001
100000000000000000000001
100000111110000000000001
100000100010000000000001
100000100010000000000001
100000100010000000000001
100000110110000000000001
100000000000000000000001
100000000000000000000001
100000000000000000000001
100000000000000000000001
100000000000000000000001
100000000000000000000001
100000000000000000000001
111111111000000000000001
110100001000000000000001
110000001000000000000001
1101000010000000N0000001
1101111110000000000000011
110000000000001000000001111111111
1111111110000000000000011
111111111111111111111111
