NO ./sprites/wall1.xpm
SO ./sprites/wall1.xpm
WE ./sprites/wall1.xpm
EA ./sprites/wall1.xpm

F 220,100,0
C 225,30,0

		1111111111111111111111111
		1000000111111111111111111
		10110001
		1001000111111111111111111
111111111011000001110000000000001
100000000011000001110111111111111
11110111111111011100000010001
111101111111110111010100100011
11000000110101011100000010001
10000000000000001100000010001
10000000000000001101010010001
11000001110101011111011110N0111
11110111 1110101 101111010001
11111111 1111111 111111111111
